NO ./textures/n_wall.xpm
SO ./textures/s_wall.xpm
WE ./textures/w_wall.xpm
EA ./textures/e_wall.xpm

F 120,164,75
C 91,144,254

111111111111111111111111111
1111111111111 1111111111111
110000000000010000000000011
110000000000000000000000011
110000000000000000000000011
110000000000000000000000011
1100000000W0000000000000011
110000000000000000000000011
110000000000010000000000011
110000000000000000000000011
110000000000000000000000011
110000000000000000000000011
110000000000000000000000011
111111111111111111111111111
11111111111111 111111111111